matriz
9, 9, 9, 9, 9, 9, 9, 9, 9, 9, 9, 9, 9, 9, 9, 9, 9, 9, 9, 9, 9
9, 1, 1, 1, 1, 1, 1, 1, 1, 1, 1, 1, 1, 1, 1, 1, 1, 1, 1, 1, 9
9, 1, F, 9, 9, 9, 9, 9, 9, 9, 9, 9, 9, 9, 9, 9, 9, 9, Q, 1, 9
9, 1, 1, 1, 1, 1, 1, 1, 1, 1, 1, 1, 1, 1, 1, 9, 1, 1, 1, 1, 9
9, 1, 1, 9, 9, 9, 9, 9, H, 9, 9, 9, 1, 1, 1, 9, 1, 1, 1, 1, 9
9, 1, 1, 9, 1, 1, 1, 1, 1, 1, 1, 9, 1, 1, 9, 9, 9, 9, 9, 1, 9
9, 1, 1, 9, 1, 9, 9, 9, Z, 1, 1, 9, 9, 9, 9, 1, 1, 1, 1, 1, 9
9, 1, 1, C, 1, 9, 1, 1, 1, 1, 1, 9, 1, 1, 9, 1, 9, O, 9, END, 9
9, 1, 1, 9, 1, 9, 1, 1, 1, 1, 1, 9, 1, 1, 9, 1, 9, 1, 1, 1, 9
9, 1, 1, 9, 1, 9, 1, 1, O, 9, 9, 9, 1, 1, 9, 1, 9, 1, 1, 1, 9
9, 1, 1, 9, 9, 9, 1, 1, 9, 1, 1, 1, 1, 1, D, 1, 9, 1, 1, 1, 9
9, 1, 1, 1, 1, 9, 1, 1, 9, 1, 1, 1, 1, 1, 9, 1, 9, 1, 1, 1, 9
9, 1, 1, 1, 1, A, 1, 1, 9, 1, 1, 1, 1, 1, 9, 1, 9, 1, 1, 1, 9
9, 1, K, 9, 1, 9, 1, 1, 9, 1, 9, 9, 9, 9, 9, 1, 9, 1, 1, 1, 9
9, 1, 9, 1, 1, 9, 1, 1, 9, 1, 1, 1, 1, 1, 1, 1, 9, 1, 1, 1, 9
9, 1, 9, 1, 1, 9, 1, 1, 9, 1, 1, 1, 1, 1, 1, 1, 9, 1, 1, 1, 9
9, 1, 9, 1, 1, 9, 1, 9, 9, 9, R, 9, 9, 9, 9, R, 9, 9, U, 1, 9
9, 1, 9, 1, 1, 9, 1, 9, 1, 1, 1, 1, 9, 1, 1, 1, 1, 1, 1, 1, 9
9, 1, 9, C, 9, 9, 1, 9, 1, 1, 1, 1, 9, 1, 1, 1, 1, 1, 1, 1, 9
9, 1, 9, 1, 1, 1, 1, W, 1, 1, 1, 1, 9, 1, 1, 1, 1, 1, 1, 1, 9
9, 1, 2, 1, 1, 1, 1, 1, 1, 1, 1, 1, M, 1, 1, 1, 1, 1, 1, 1, 9
9, 1, 1, 1, 1, 1, 1, 1, 1, 1, 1, 1, 1, 1, 1, 1, 1, 1, 1, 1, 9
9, 9, 9, 9, 9, 9, 9, 9, 9, 9, 9, 9, 9, 9, 9, 9, 9, 9, 9, 9, 9

nome = CACHORRO

figura = cachorro.png