matriz
9, 9, 9, 9, 9, 9, 9, 9, 9, 9, 9, 9, 9, 9, 9, 9, 9, 9, 9, 9, 9
9, 1, 1, 1, 1, 1, 1, 1, 1, 1, 1, 1, 1, 1, 1, 1, 1, 1, 1, 1, 9
9, 1, 1, 1, 9, Q, 9, 9, 9, 9, 9, 9, 9, 9, 1, 1, 1, 1, 1, 1, 9
9, 1, 1, 1, 9, 1, 1, 1, 1, 1, 1, 1, 1, 9, 1, 1, 1, 1, 1, 1, 9
9, 1, 1, 1, 9, 1, 1, 1, 1, 1, 1, 1, 1, 9, 1, 1, 1, 1, 1, 1, 9
9, 1, 1, 1, 9, 1, 1, 1, 9, 9, 9, 9, 9, U, 9, 9, 9, E, 9, 1, 9
9, 1, 9, 1, 9, 1, 1, 1, 9, 1, 1, 1, 1, 1, 1, 1, 9, 1, 9, 1, 9
9, 1, 9, 1, 9, 1, 1, 1, 9, 1, 1, 1, 1, 1, 1, 1, 9, 1, 9, 1, 9
9, 1, 9, 1, 9, 1, 1, 1, 9, 1, 1, 1, 1, 1, 1, 1, 9, 1, 9, 1, 9
9, 1, 9, 1, 9, 1, 1, 1, 9, 1, 1, 1, 1, 1, 1, 1, 9, 1, 9, 1, 9
9, 1, 9, 9, 9, 9, 9, 9, 9, 1, 1, 9, 9, 9, 9, K, 9, 1, 9, 1, 9
9, 1, 9, 1, 1, 1, 1, 1, 9, 1, 1, 9, 1, 1, 1, 1, 1, 1, D, 1, 9
9, 1, 9, 1, 1, 1, 1, 1, 9, 1, 1, 9, 1, 1, 1, 1, 1, 1, 9, 1, 9
9, 1, 9, 1, 1, 1, 1, 1, 9, 1, 1, 9, 1, 1, 1, 1, 1, 1, 9, 1, 9
9, 1, 9, 1, 1, 1, 1, 1, 9, 9, 9, N, 9, 9, 1, 9, 9, 9, 9, 1, 9
9, 1, 9, 1, 1, 1, 1, 1, 1, 1, 1, 1, 1, 9, 1, 9, 1, 1, 9, 1, 9
9, 1, 9, 1, 2, 9, 1, 9, 1, 1, 1, 1, 1, 9, 1, U, 1, 1, 9, 1, 9
9, 1, 9, 1, 1, 9, 1, 9, 1, 1, 1, 1, 1, 9, 1, 9, 1, 1, 9, 1, 9
9, 1, 9, 1, 1, 9, 1, 9, 9, 9, L, 9, 9, I, 1, 9, 1, 1, 9, 1, 9
9, 1, 9, 9, 9, B, 1, 9, 1, 1, 1, 1, 1, 9, 1, 9, 1, 1, 9, 1, 9
9, 1, 1, 1, 1, 9, 9, 9, 9, 9, R, 9, 9, 9, 1, 9, 1, 1, O, 1, 9
9, 1, 1, 1, 1, 1, 1, 1, 1, 1, 1, 1, 1, 1, 1, 1, 1, 1, END, 1, 9
9, 9, 9, 9, 9, 9, 9, 9, 9, 9, 9, 9, 9, 9, 9, 9, 9, 9, 9, 9, 9

nome = BRINQUEDO

figura = brinquedo.png